Id,Id2,Geography,Estimate; Total:,Under 50K,Over 50K
0400000US19,19,Iowa,1236409,579398,657011
8600000US50001,50001,ZCTA5 50001,234,94,140
8600000US50002,50002,ZCTA5 50002,629,322,307
8600000US50003,50003,ZCTA5 50003,2700,924,1776
8600000US50005,50005,ZCTA5 50005,335,117,218
8600000US50006,50006,ZCTA5 50006,625,316,309
8600000US50007,50007,ZCTA5 50007,198,47,151
8600000US50008,50008,ZCTA5 50008,393,272,121
8600000US50009,50009,ZCTA5 50009,6586,2214,4372
8600000US50010,50010,ZCTA5 50010,13549,6947,6602
8600000US50011,50011,ZCTA5 50011,0,0,0
8600000US50012,50012,ZCTA5 50012,7,7,0
8600000US50014,50014,ZCTA5 50014,11817,6948,4869
8600000US50020,50020,ZCTA5 50020,585,319,266
8600000US50021,50021,ZCTA5 50021,9870,2912,6958
8600000US50022,50022,ZCTA5 50022,3804,2317,1487
8600000US50023,50023,ZCTA5 50023,11137,3155,7982
8600000US50025,50025,ZCTA5 50025,1444,722,722
8600000US50026,50026,ZCTA5 50026,305,164,141
8600000US50027,50027,ZCTA5 50027,140,78,62
8600000US50028,50028,ZCTA5 50028,615,232,383
8600000US50029,50029,ZCTA5 50029,279,133,146
8600000US50032,50032,ZCTA5 50032,32,32,0
8600000US50033,50033,ZCTA5 50033,12,5,7
8600000US50034,50034,ZCTA5 50034,147,70,77
8600000US50035,50035,ZCTA5 50035,1994,611,1383
8600000US50036,50036,ZCTA5 50036,6859,3328,3531
8600000US50038,50038,ZCTA5 50038,68,42,26
8600000US50039,50039,ZCTA5 50039,212,72,140
8600000US50041,50041,ZCTA5 50041,36,29,7
8600000US50042,50042,ZCTA5 50042,147,86,61
8600000US50044,50044,ZCTA5 50044,429,212,217
8600000US50046,50046,ZCTA5 50046,482,184,298
8600000US50047,50047,ZCTA5 50047,2208,916,1292
8600000US50048,50048,ZCTA5 50048,341,175,166
8600000US50049,50049,ZCTA5 50049,2805,1573,1232
8600000US50050,50050,ZCTA5 50050,300,168,132
8600000US50051,50051,ZCTA5 50051,161,64,97
8600000US50052,50052,ZCTA5 50052,78,35,43
8600000US50054,50054,ZCTA5 50054,1217,542,675
8600000US50055,50055,ZCTA5 50055,363,128,235
8600000US50056,50056,ZCTA5 50056,537,237,300
8600000US50057,50057,ZCTA5 50057,86,29,57
8600000US50058,50058,ZCTA5 50058,797,388,409
8600000US50060,50060,ZCTA5 50060,986,512,474
8600000US50061,50061,ZCTA5 50061,674,194,480
8600000US50062,50062,ZCTA5 50062,258,151,107
8600000US50063,50063,ZCTA5 50063,967,302,665
8600000US50064,50064,ZCTA5 50064,46,36,10
8600000US50065,50065,ZCTA5 50065,262,174,88
8600000US50066,50066,ZCTA5 50066,146,82,64
8600000US50067,50067,ZCTA5 50067,98,55,43
8600000US50068,50068,ZCTA5 50068,116,55,61
8600000US50069,50069,ZCTA5 50069,462,191,271
8600000US50070,50070,ZCTA5 50070,635,215,420
8600000US50071,50071,ZCTA5 50071,412,216,196
8600000US50072,50072,ZCTA5 50072,1042,332,710
8600000US50073,50073,ZCTA5 50073,430,177,253
8600000US50074,50074,ZCTA5 50074,201,70,131
8600000US50075,50075,ZCTA5 50075,308,139,169
8600000US50076,50076,ZCTA5 50076,710,412,298
8600000US50078,50078,ZCTA5 50078,61,35,26
8600000US50101,50101,ZCTA5 50101,32,12,20
8600000US50102,50102,ZCTA5 50102,34,5,29
8600000US50103,50103,ZCTA5 50103,172,94,78
8600000US50104,50104,ZCTA5 50104,56,32,24
8600000US50105,50105,ZCTA5 50105,429,108,321
8600000US50106,50106,ZCTA5 50106,481,169,312
8600000US50107,50107,ZCTA5 50107,461,231,230
8600000US50108,50108,ZCTA5 50108,202,142,60
8600000US50109,50109,ZCTA5 50109,1115,385,730
8600000US50111,50111,ZCTA5 50111,4063,972,3091
8600000US50112,50112,ZCTA5 50112,4406,2248,2158
8600000US50115,50115,ZCTA5 50115,1107,590,517
8600000US50116,50116,ZCTA5 50116,81,55,26
8600000US50117,50117,ZCTA5 50117,63,36,27
8600000US50118,50118,ZCTA5 50118,399,134,265
8600000US50119,50119,ZCTA5 50119,201,80,121
8600000US50120,50120,ZCTA5 50120,111,30,81
8600000US50122,50122,ZCTA5 50122,574,232,342
8600000US50123,50123,ZCTA5 50123,355,195,160
8600000US50124,50124,ZCTA5 50124,1440,497,943
8600000US50125,50125,ZCTA5 50125,7367,3273,4094
8600000US50126,50126,ZCTA5 50126,2766,1386,1380
8600000US50127,50127,ZCTA5 50127,9,9,0
8600000US50128,50128,ZCTA5 50128,143,62,81
8600000US50129,50129,ZCTA5 50129,2205,1190,1015
8600000US50130,50130,ZCTA5 50130,673,278,395
8600000US50131,50131,ZCTA5 50131,7671,1767,5904
8600000US50132,50132,ZCTA5 50132,155,109,46
8600000US50133,50133,ZCTA5 50133,186,124,62
8600000US50134,50134,ZCTA5 50134,244,56,188
8600000US50135,50135,ZCTA5 50135,716,343,373
8600000US50136,50136,ZCTA5 50136,162,82,80
8600000US50138,50138,ZCTA5 50138,4772,2361,2411
8600000US50139,50139,ZCTA5 50139,577,241,336
8600000US50140,50140,ZCTA5 50140,1078,692,386
8600000US50141,50141,ZCTA5 50141,240,95,145
8600000US50142,50142,ZCTA5 50142,396,171,225
8600000US50143,50143,ZCTA5 50143,212,42,170
8600000US50144,50144,ZCTA5 50144,1045,637,408
8600000US50146,50146,ZCTA5 50146,147,92,55
8600000US50147,50147,ZCTA5 50147,201,115,86
8600000US50148,50148,ZCTA5 50148,200,109,91
8600000US50149,50149,ZCTA5 50149,423,259,164
8600000US50150,50150,ZCTA5 50150,435,261,174
8600000US50151,50151,ZCTA5 50151,243,127,116
8600000US50153,50153,ZCTA5 50153,343,109,234
8600000US50154,50154,ZCTA5 50154,180,103,77
8600000US50155,50155,ZCTA5 50155,147,108,39
8600000US50156,50156,ZCTA5 50156,1723,647,1076
8600000US50157,50157,ZCTA5 50157,296,152,144
8600000US50158,50158,ZCTA5 50158,11569,5449,6120
8600000US50160,50160,ZCTA5 50160,185,87,98
8600000US50161,50161,ZCTA5 50161,839,279,560
8600000US50162,50162,ZCTA5 50162,548,198,350
8600000US50163,50163,ZCTA5 50163,386,283,103
8600000US50164,50164,ZCTA5 50164,243,133,110
8600000US50165,50165,ZCTA5 50165,14,5,9
8600000US50166,50166,ZCTA5 50166,606,204,402
8600000US50167,50167,ZCTA5 50167,238,105,133
8600000US50168,50168,ZCTA5 50168,302,118,184
8600000US50169,50169,ZCTA5 50169,1051,446,605
8600000US50170,50170,ZCTA5 50170,1141,469,672
8600000US50171,50171,ZCTA5 50171,1133,430,703
8600000US50173,50173,ZCTA5 50173,311,107,204
8600000US50174,50174,ZCTA5 50174,569,339,230
8600000US50201,50201,ZCTA5 50201,3424,1267,2157
8600000US50206,50206,ZCTA5 50206,142,68,74
8600000US50207,50207,ZCTA5 50207,954,368,586
8600000US50208,50208,ZCTA5 50208,7868,3931,3937
8600000US50210,50210,ZCTA5 50210,632,210,422
8600000US50211,50211,ZCTA5 50211,4543,1199,3344
8600000US50212,50212,ZCTA5 50212,1357,615,742
8600000US50213,50213,ZCTA5 50213,2755,1594,1161
8600000US50214,50214,ZCTA5 50214,267,34,233
8600000US50216,50216,ZCTA5 50216,1080,471,609
8600000US50217,50217,ZCTA5 50217,285,153,132
8600000US50218,50218,ZCTA5 50218,57,29,28
8600000US50219,50219,ZCTA5 50219,5053,1876,3177
8600000US50220,50220,ZCTA5 50220,3235,1724,1511
8600000US50222,50222,ZCTA5 50222,202,105,97
8600000US50223,50223,ZCTA5 50223,224,136,88
8600000US50225,50225,ZCTA5 50225,1214,470,744
8600000US50226,50226,ZCTA5 50226,1978,312,1666
8600000US50227,50227,ZCTA5 50227,7,1,6
8600000US50228,50228,ZCTA5 50228,947,353,594
8600000US50229,50229,ZCTA5 50229,315,84,231
8600000US50230,50230,ZCTA5 50230,437,164,273
8600000US50231,50231,ZCTA5 50231,78,45,33
8600000US50232,50232,ZCTA5 50232,199,69,130
8600000US50233,50233,ZCTA5 50233,573,245,328
8600000US50234,50234,ZCTA5 50234,284,93,191
8600000US50235,50235,ZCTA5 50235,162,74,88
8600000US50236,50236,ZCTA5 50236,625,195,430
8600000US50237,50237,ZCTA5 50237,1156,294,862
8600000US50238,50238,ZCTA5 50238,462,234,228
8600000US50239,50239,ZCTA5 50239,48,23,25
8600000US50240,50240,ZCTA5 50240,1035,319,716
8600000US50242,50242,ZCTA5 50242,138,83,55
8600000US50243,50243,ZCTA5 50243,91,43,48
8600000US50244,50244,ZCTA5 50244,682,212,470
8600000US50246,50246,ZCTA5 50246,308,137,171
8600000US50247,50247,ZCTA5 50247,814,322,492
8600000US50248,50248,ZCTA5 50248,1797,784,1013
8600000US50249,50249,ZCTA5 50249,470,219,251
8600000US50250,50250,ZCTA5 50250,990,567,423
8600000US50251,50251,ZCTA5 50251,507,198,309
8600000US50252,50252,ZCTA5 50252,91,41,50
8600000US50254,50254,ZCTA5 50254,115,28,87
8600000US50255,50255,ZCTA5 50255,40,20,20
8600000US50256,50256,ZCTA5 50256,242,58,184
8600000US50257,50257,ZCTA5 50257,404,172,232
8600000US50258,50258,ZCTA5 50258,398,162,236
8600000US50261,50261,ZCTA5 50261,830,184,646
8600000US50262,50262,ZCTA5 50262,170,86,84
8600000US50263,50263,ZCTA5 50263,7000,1838,5162
8600000US50264,50264,ZCTA5 50264,179,84,95
8600000US50265,50265,ZCTA5 50265,13954,4821,9133
8600000US50266,50266,ZCTA5 50266,11252,3594,7658
8600000US50268,50268,ZCTA5 50268,412,277,135
8600000US50271,50271,ZCTA5 50271,265,121,144
8600000US50272,50272,ZCTA5 50272,44,29,15
8600000US50273,50273,ZCTA5 50273,3351,1485,1866
8600000US50274,50274,ZCTA5 50274,173,94,79
8600000US50275,50275,ZCTA5 50275,262,174,88
8600000US50276,50276,ZCTA5 50276,948,345,603
8600000US50277,50277,ZCTA5 50277,227,129,98
8600000US50278,50278,ZCTA5 50278,357,140,217
8600000US50309,50309,ZCTA5 50309,3330,2162,1168
8600000US50310,50310,ZCTA5 50310,12950,5434,7516
8600000US50311,50311,ZCTA5 50311,5705,3209,2496
8600000US50312,50312,ZCTA5 50312,7293,3276,4017
8600000US50313,50313,ZCTA5 50313,6543,3498,3045
8600000US50314,50314,ZCTA5 50314,4029,2923,1106
8600000US50315,50315,ZCTA5 50315,14040,7895,6145
8600000US50316,50316,ZCTA5 50316,5673,3402,2271
8600000US50317,50317,ZCTA5 50317,14251,7827,6424
8600000US50319,50319,ZCTA5 50319,0,0,0
8600000US50320,50320,ZCTA5 50320,7425,3407,4018
8600000US50321,50321,ZCTA5 50321,3370,1581,1789
8600000US50322,50322,ZCTA5 50322,13524,5030,8494
8600000US50323,50323,ZCTA5 50323,4108,532,3576
8600000US50324,50324,ZCTA5 50324,2086,982,1104
8600000US50325,50325,ZCTA5 50325,6109,1571,4538
8600000US50327,50327,ZCTA5 50327,4115,1121,2994
8600000US50401,50401,ZCTA5 50401,13377,7654,5723
8600000US50420,50420,ZCTA5 50420,179,95,84
8600000US50421,50421,ZCTA5 50421,1361,762,599
8600000US50423,50423,ZCTA5 50423,1223,610,613
8600000US50424,50424,ZCTA5 50424,628,279,349
8600000US50426,50426,ZCTA5 50426,16,9,7
8600000US50428,50428,ZCTA5 50428,3938,1880,2058
8600000US50430,50430,ZCTA5 50430,218,117,101
8600000US50431,50431,ZCTA5 50431,123,60,63
8600000US50432,50432,ZCTA5 50432,109,83,26
8600000US50433,50433,ZCTA5 50433,88,29,59
8600000US50434,50434,ZCTA5 50434,193,123,70
8600000US50435,50435,ZCTA5 50435,253,119,134
8600000US50436,50436,ZCTA5 50436,2549,1286,1263
8600000US50438,50438,ZCTA5 50438,1590,606,984
8600000US50439,50439,ZCTA5 50439,134,81,53
8600000US50440,50440,ZCTA5 50440,249,134,115
8600000US50441,50441,ZCTA5 50441,2262,1172,1090
8600000US50444,50444,ZCTA5 50444,136,43,93
8600000US50446,50446,ZCTA5 50446,254,118,136
8600000US50447,50447,ZCTA5 50447,516,260,256
8600000US50448,50448,ZCTA5 50448,316,155,161
8600000US50449,50449,ZCTA5 50449,241,122,119
8600000US50450,50450,ZCTA5 50450,1209,685,524
8600000US50451,50451,ZCTA5 50451,232,116,116
8600000US50452,50452,ZCTA5 50452,312,149,163
8600000US50453,50453,ZCTA5 50453,245,120,125
8600000US50454,50454,ZCTA5 50454,53,38,15
8600000US50455,50455,ZCTA5 50455,161,95,66
8600000US50456,50456,ZCTA5 50456,729,363,366
8600000US50457,50457,ZCTA5 50457,152,52,100
8600000US50458,50458,ZCTA5 50458,871,456,415
8600000US50459,50459,ZCTA5 50459,1247,682,565
8600000US50460,50460,ZCTA5 50460,102,48,54
8600000US50461,50461,ZCTA5 50461,2383,1212,1171
8600000US50464,50464,ZCTA5 50464,264,140,124
8600000US50465,50465,ZCTA5 50465,117,77,40
8600000US50466,50466,ZCTA5 50466,686,360,326
8600000US50467,50467,ZCTA5 50467,33,14,19
8600000US50468,50468,ZCTA5 50468,645,277,368
8600000US50469,50469,ZCTA5 50469,684,280,404
8600000US50470,50470,ZCTA5 50470,108,75,33
8600000US50471,50471,ZCTA5 50471,361,219,142
8600000US50472,50472,ZCTA5 50472,907,447,460
8600000US50473,50473,ZCTA5 50473,104,38,66
8600000US50475,50475,ZCTA5 50475,667,358,309
8600000US50476,50476,ZCTA5 50476,371,153,218
8600000US50477,50477,ZCTA5 50477,163,94,69
8600000US50478,50478,ZCTA5 50478,378,210,168
8600000US50479,50479,ZCTA5 50479,287,203,84
8600000US50480,50480,ZCTA5 50480,424,242,182
8600000US50482,50482,ZCTA5 50482,419,138,281
8600000US50483,50483,ZCTA5 50483,298,152,146
8600000US50484,50484,ZCTA5 50484,186,92,94
8600000US50501,50501,ZCTA5 50501,11263,6661,4602
8600000US50510,50510,ZCTA5 50510,435,208,227
8600000US50511,50511,ZCTA5 50511,3220,1433,1787
8600000US50514,50514,ZCTA5 50514,652,340,312
8600000US50515,50515,ZCTA5 50515,113,68,45
8600000US50516,50516,ZCTA5 50516,272,93,179
8600000US50517,50517,ZCTA5 50517,415,224,191
8600000US50518,50518,ZCTA5 50518,156,60,96
8600000US50519,50519,ZCTA5 50519,253,124,129
8600000US50520,50520,ZCTA5 50520,61,35,26
8600000US50521,50521,ZCTA5 50521,61,35,26
8600000US50522,50522,ZCTA5 50522,288,149,139
8600000US50523,50523,ZCTA5 50523,323,145,178
8600000US50524,50524,ZCTA5 50524,259,81,178
8600000US50525,50525,ZCTA5 50525,1420,775,645
8600000US50527,50527,ZCTA5 50527,110,55,55
8600000US50528,50528,ZCTA5 50528,169,71,98
8600000US50529,50529,ZCTA5 50529,343,190,153
8600000US50530,50530,ZCTA5 50530,496,267,229
8600000US50531,50531,ZCTA5 50531,110,26,84
8600000US50532,50532,ZCTA5 50532,437,249,188
8600000US50533,50533,ZCTA5 50533,1622,920,702
8600000US50535,50535,ZCTA5 50535,433,254,179
8600000US50536,50536,ZCTA5 50536,1913,1007,906
8600000US50538,50538,ZCTA5 50538,235,114,121
8600000US50539,50539,ZCTA5 50539,239,100,139
8600000US50540,50540,ZCTA5 50540,399,220,179
8600000US50541,50541,ZCTA5 50541,351,198,153
8600000US50542,50542,ZCTA5 50542,451,223,228
8600000US50543,50543,ZCTA5 50543,636,328,308
8600000US50544,50544,ZCTA5 50544,204,117,87
8600000US50545,50545,ZCTA5 50545,97,41,56
8600000US50546,50546,ZCTA5 50546,128,77,51
8600000US50548,50548,ZCTA5 50548,2516,1294,1222
8600000US50551,50551,ZCTA5 50551,38,20,18
8600000US50554,50554,ZCTA5 50554,759,415,344
8600000US50556,50556,ZCTA5 50556,123,81,42
8600000US50557,50557,ZCTA5 50557,346,185,161
8600000US50558,50558,ZCTA5 50558,293,128,165
8600000US50559,50559,ZCTA5 50559,143,66,77
8600000US50560,50560,ZCTA5 50560,231,127,104
8600000US50561,50561,ZCTA5 50561,203,106,97
8600000US50562,50562,ZCTA5 50562,230,128,102
8600000US50563,50563,ZCTA5 50563,1176,661,515
8600000US50565,50565,ZCTA5 50565,228,130,98
8600000US50566,50566,ZCTA5 50566,168,95,73
8600000US50567,50567,ZCTA5 50567,101,46,55
8600000US50568,50568,ZCTA5 50568,631,266,365
8600000US50569,50569,ZCTA5 50569,338,190,148
8600000US50570,50570,ZCTA5 50570,94,36,58
8600000US50571,50571,ZCTA5 50571,178,79,99
8600000US50573,50573,ZCTA5 50573,19,13,6
8600000US50574,50574,ZCTA5 50574,971,519,452
8600000US50575,50575,ZCTA5 50575,501,285,216
8600000US50576,50576,ZCTA5 50576,137,59,78
8600000US50577,50577,ZCTA5 50577,177,84,93
8600000US50578,50578,ZCTA5 50578,316,188,128
8600000US50579,50579,ZCTA5 50579,1053,559,494
8600000US50581,50581,ZCTA5 50581,394,218,176
8600000US50582,50582,ZCTA5 50582,111,72,39
8600000US50583,50583,ZCTA5 50583,1296,678,618
8600000US50585,50585,ZCTA5 50585,463,232,231
8600000US50586,50586,ZCTA5 50586,155,89,66
8600000US50588,50588,ZCTA5 50588,4494,2455,2039
8600000US50590,50590,ZCTA5 50590,428,270,158
8600000US50591,50591,ZCTA5 50591,119,54,65
8600000US50593,50593,ZCTA5 50593,26,19,7
8600000US50594,50594,ZCTA5 50594,111,55,56
8600000US50595,50595,ZCTA5 50595,3885,2066,1819
8600000US50597,50597,ZCTA5 50597,572,314,258
8600000US50598,50598,ZCTA5 50598,365,159,206
8600000US50599,50599,ZCTA5 50599,163,61,102
8600000US50601,50601,ZCTA5 50601,1084,566,518
8600000US50602,50602,ZCTA5 50602,715,268,447
8600000US50603,50603,ZCTA5 50603,263,147,116
8600000US50604,50604,ZCTA5 50604,730,296,434
8600000US50605,50605,ZCTA5 50605,78,33,45
8600000US50606,50606,ZCTA5 50606,385,216,169
8600000US50607,50607,ZCTA5 50607,194,107,87
8600000US50609,50609,ZCTA5 50609,181,79,102
8600000US50611,50611,ZCTA5 50611,177,75,102
8600000US50612,50612,ZCTA5 50612,139,34,105
8600000US50613,50613,ZCTA5 50613,15719,7087,8632
8600000US50616,50616,ZCTA5 50616,4520,2544,1976
8600000US50619,50619,ZCTA5 50619,942,494,448
8600000US50620,50620,ZCTA5 50620,20,12,8
8600000US50621,50621,ZCTA5 50621,672,282,390
8600000US50622,50622,ZCTA5 50622,1326,439,887
8600000US50624,50624,ZCTA5 50624,719,215,504
8600000US50625,50625,ZCTA5 50625,425,227,198
8600000US50626,50626,ZCTA5 50626,714,297,417
8600000US50627,50627,ZCTA5 50627,1340,670,670
8600000US50628,50628,ZCTA5 50628,557,302,255
8600000US50629,50629,ZCTA5 50629,857,373,484
8600000US50630,50630,ZCTA5 50630,882,466,416
8600000US50632,50632,ZCTA5 50632,421,182,239
8600000US50633,50633,ZCTA5 50633,175,113,62
8600000US50634,50634,ZCTA5 50634,344,174,170
8600000US50635,50635,ZCTA5 50635,675,265,410
8600000US50636,50636,ZCTA5 50636,826,422,404
8600000US50638,50638,ZCTA5 50638,1400,687,713
8600000US50641,50641,ZCTA5 50641,632,352,280
8600000US50642,50642,ZCTA5 50642,186,77,109
8600000US50643,50643,ZCTA5 50643,1107,286,821
8600000US50644,50644,ZCTA5 50644,3577,1552,2025
8600000US50645,50645,ZCTA5 50645,453,278,175
8600000US50647,50647,ZCTA5 50647,721,289,432
8600000US50648,50648,ZCTA5 50648,1662,637,1025
8600000US50650,50650,ZCTA5 50650,252,131,121
8600000US50651,50651,ZCTA5 50651,1403,570,833
8600000US50652,50652,ZCTA5 50652,45,40,5
8600000US50653,50653,ZCTA5 50653,213,94,119
8600000US50654,50654,ZCTA5 50654,190,87,103
8600000US50655,50655,ZCTA5 50655,320,158,162
8600000US50658,50658,ZCTA5 50658,1028,481,547
8600000US50659,50659,ZCTA5 50659,2352,1270,1082
8600000US50660,50660,ZCTA5 50660,579,221,358
8600000US50662,50662,ZCTA5 50662,3030,1939,1091
8600000US50664,50664,ZCTA5 50664,17,0,17
8600000US50665,50665,ZCTA5 50665,1211,603,608
8600000US50666,50666,ZCTA5 50666,370,141,229
8600000US50667,50667,ZCTA5 50667,305,101,204
8600000US50668,50668,ZCTA5 50668,512,202,310
8600000US50669,50669,ZCTA5 50669,1080,500,580
8600000US50670,50670,ZCTA5 50670,853,345,508
8600000US50671,50671,ZCTA5 50671,88,29,59
8600000US50672,50672,ZCTA5 50672,214,115,99
8600000US50673,50673,ZCTA5 50673,69,25,44
8600000US50674,50674,ZCTA5 50674,1497,620,877
8600000US50675,50675,ZCTA5 50675,983,409,574
8600000US50676,50676,ZCTA5 50676,869,453,416
8600000US50677,50677,ZCTA5 50677,4380,1654,2726
8600000US50680,50680,ZCTA5 50680,553,244,309
8600000US50681,50681,ZCTA5 50681,188,64,124
8600000US50682,50682,ZCTA5 50682,648,199,449
8600000US50701,50701,ZCTA5 50701,12738,6139,6599
8600000US50702,50702,ZCTA5 50702,8542,4869,3673
8600000US50703,50703,ZCTA5 50703,7757,5267,2490
8600000US50707,50707,ZCTA5 50707,3439,2036,1403
8600000US50801,50801,ZCTA5 50801,4034,2285,1749
8600000US50830,50830,ZCTA5 50830,723,379,344
8600000US50833,50833,ZCTA5 50833,925,514,411
8600000US50835,50835,ZCTA5 50835,50,9,41
8600000US50836,50836,ZCTA5 50836,177,105,72
8600000US50837,50837,ZCTA5 50837,142,96,46
8600000US50839,50839,ZCTA5 50839,18,16,2
8600000US50840,50840,ZCTA5 50840,244,148,96
8600000US50841,50841,ZCTA5 50841,1196,619,577
8600000US50842,50842,ZCTA5 50842,40,17,23
8600000US50843,50843,ZCTA5 50843,255,153,102
8600000US50845,50845,ZCTA5 50845,308,163,145
8600000US50846,50846,ZCTA5 50846,475,278,197
8600000US50847,50847,ZCTA5 50847,37,32,5
8600000US50848,50848,ZCTA5 50848,202,101,101
8600000US50849,50849,ZCTA5 50849,1140,624,516
8600000US50851,50851,ZCTA5 50851,926,539,387
8600000US50853,50853,ZCTA5 50853,306,163,143
8600000US50854,50854,ZCTA5 50854,955,547,408
8600000US50857,50857,ZCTA5 50857,123,61,62
8600000US50858,50858,ZCTA5 50858,318,147,171
8600000US50859,50859,ZCTA5 50859,279,124,155
8600000US50860,50860,ZCTA5 50860,128,79,49
8600000US50861,50861,ZCTA5 50861,142,83,59
8600000US50862,50862,ZCTA5 50862,59,27,32
8600000US50863,50863,ZCTA5 50863,114,43,71
8600000US50864,50864,ZCTA5 50864,891,553,338
8600000US51001,51001,ZCTA5 51001,1014,474,540
8600000US51002,51002,ZCTA5 51002,1160,566,594
8600000US51003,51003,ZCTA5 51003,697,261,436
8600000US51004,51004,ZCTA5 51004,510,276,234
8600000US51005,51005,ZCTA5 51005,623,271,352
8600000US51006,51006,ZCTA5 51006,498,297,201
8600000US51007,51007,ZCTA5 51007,254,94,160
8600000US51008,51008,ZCTA5 51008,48,22,26
8600000US51009,51009,ZCTA5 51009,93,33,60
8600000US51010,51010,ZCTA5 51010,203,146,57
8600000US51011,51011,ZCTA5 51011,24,12,12
8600000US51012,51012,ZCTA5 51012,2917,1564,1353
8600000US51014,51014,ZCTA5 51014,213,79,134
8600000US51016,51016,ZCTA5 51016,528,302,226
8600000US51018,51018,ZCTA5 51018,169,104,65
8600000US51019,51019,ZCTA5 51019,323,138,185
8600000US51020,51020,ZCTA5 51020,244,116,128
8600000US51022,51022,ZCTA5 51022,328,139,189
8600000US51023,51023,ZCTA5 51023,1275,582,693
8600000US51024,51024,ZCTA5 51024,706,220,486
8600000US51025,51025,ZCTA5 51025,859,416,443
8600000US51026,51026,ZCTA5 51026,364,157,207
8600000US51027,51027,ZCTA5 51027,435,204,231
8600000US51028,51028,ZCTA5 51028,815,306,509
8600000US51029,51029,ZCTA5 51029,161,67,94
8600000US51030,51030,ZCTA5 51030,641,183,458
8600000US51031,51031,ZCTA5 51031,5087,2363,2724
8600000US51033,51033,ZCTA5 51033,218,94,124
8600000US51034,51034,ZCTA5 51034,830,430,400
8600000US51035,51035,ZCTA5 51035,750,344,406
8600000US51036,51036,ZCTA5 51036,211,89,122
8600000US51037,51037,ZCTA5 51037,159,111,48
8600000US51038,51038,ZCTA5 51038,716,315,401
8600000US51039,51039,ZCTA5 51039,947,367,580
8600000US51040,51040,ZCTA5 51040,1548,1007,541
8600000US51041,51041,ZCTA5 51041,2301,863,1438
8600000US51044,51044,ZCTA5 51044,87,51,36
8600000US51046,51046,ZCTA5 51046,712,305,407
8600000US51047,51047,ZCTA5 51047,320,151,169
8600000US51048,51048,ZCTA5 51048,264,150,114
8600000US51049,51049,ZCTA5 51049,224,136,88
8600000US51050,51050,ZCTA5 51050,990,394,596
8600000US51051,51051,ZCTA5 51051,42,38,4
8600000US51052,51052,ZCTA5 51052,347,120,227
8600000US51053,51053,ZCTA5 51053,451,226,225
8600000US51054,51054,ZCTA5 51054,1760,592,1168
8600000US51055,51055,ZCTA5 51055,567,226,341
8600000US51056,51056,ZCTA5 51056,192,100,92
8600000US51058,51058,ZCTA5 51058,415,202,213
8600000US51060,51060,ZCTA5 51060,259,156,103
8600000US51061,51061,ZCTA5 51061,235,114,121
8600000US51062,51062,ZCTA5 51062,215,101,114
8600000US51063,51063,ZCTA5 51063,505,276,229
8600000US51101,51101,ZCTA5 51101,445,431,14
8600000US51103,51103,ZCTA5 51103,6117,3875,2242
8600000US51104,51104,ZCTA5 51104,8381,3826,4555
8600000US51105,51105,ZCTA5 51105,3565,2683,882
8600000US51106,51106,ZCTA5 51106,10439,5023,5416
8600000US51108,51108,ZCTA5 51108,2139,1065,1074
8600000US51109,51109,ZCTA5 51109,1234,772,462
8600000US51111,51111,ZCTA5 51111,72,18,54
8600000US51201,51201,ZCTA5 51201,2631,1177,1454
8600000US51230,51230,ZCTA5 51230,136,56,80
8600000US51231,51231,ZCTA5 51231,135,42,93
8600000US51232,51232,ZCTA5 51232,370,192,178
8600000US51234,51234,ZCTA5 51234,434,190,244
8600000US51235,51235,ZCTA5 51235,406,155,251
8600000US51237,51237,ZCTA5 51237,707,317,390
8600000US51238,51238,ZCTA5 51238,437,185,252
8600000US51239,51239,ZCTA5 51239,1107,434,673
8600000US51240,51240,ZCTA5 51240,697,335,362
8600000US51241,51241,ZCTA5 51241,653,208,445
8600000US51242,51242,ZCTA5 51242,88,29,59
8600000US51243,51243,ZCTA5 51243,406,158,248
8600000US51244,51244,ZCTA5 51244,30,11,19
8600000US51245,51245,ZCTA5 51245,450,208,242
8600000US51246,51246,ZCTA5 51246,1412,628,784
8600000US51247,51247,ZCTA5 51247,1747,738,1009
8600000US51248,51248,ZCTA5 51248,746,354,392
8600000US51249,51249,ZCTA5 51249,1358,769,589
8600000US51250,51250,ZCTA5 51250,2684,816,1868
8600000US51301,51301,ZCTA5 51301,5489,2793,2696
8600000US51331,51331,ZCTA5 51331,594,330,264
8600000US51333,51333,ZCTA5 51333,191,81,110
8600000US51334,51334,ZCTA5 51334,3011,1596,1415
8600000US51338,51338,ZCTA5 51338,395,148,247
8600000US51341,51341,ZCTA5 51341,26,17,9
8600000US51342,51342,ZCTA5 51342,479,268,211
8600000US51343,51343,ZCTA5 51343,133,73,60
8600000US51345,51345,ZCTA5 51345,200,75,125
8600000US51346,51346,ZCTA5 51346,1002,491,511
8600000US51347,51347,ZCTA5 51347,590,232,358
8600000US51350,51350,ZCTA5 51350,212,82,130
8600000US51351,51351,ZCTA5 51351,1998,944,1054
8600000US51354,51354,ZCTA5 51354,484,226,258
8600000US51355,51355,ZCTA5 51355,400,177,223
8600000US51357,51357,ZCTA5 51357,263,140,123
8600000US51358,51358,ZCTA5 51358,529,294,235
8600000US51360,51360,ZCTA5 51360,3899,1497,2402
8600000US51363,51363,ZCTA5 51363,62,32,30
8600000US51364,51364,ZCTA5 51364,301,157,144
8600000US51365,51365,ZCTA5 51365,109,58,51
8600000US51366,51366,ZCTA5 51366,164,89,75
8600000US51401,51401,ZCTA5 51401,5120,2594,2526
8600000US51430,51430,ZCTA5 51430,302,115,187
8600000US51431,51431,ZCTA5 51431,186,88,98
8600000US51433,51433,ZCTA5 51433,225,116,109
8600000US51436,51436,ZCTA5 51436,296,129,167
8600000US51439,51439,ZCTA5 51439,451,204,247
8600000US51440,51440,ZCTA5 51440,135,51,84
8600000US51441,51441,ZCTA5 51441,197,145,52
8600000US51442,51442,ZCTA5 51442,3222,1727,1495
8600000US51443,51443,ZCTA5 51443,731,339,392
8600000US51444,51444,ZCTA5 51444,90,38,52
8600000US51445,51445,ZCTA5 51445,1265,691,574
8600000US51446,51446,ZCTA5 51446,241,158,83
8600000US51447,51447,ZCTA5 51447,86,40,46
8600000US51448,51448,ZCTA5 51448,240,141,99
8600000US51449,51449,ZCTA5 51449,922,520,402
8600000US51450,51450,ZCTA5 51450,718,334,384
8600000US51451,51451,ZCTA5 51451,45,35,10
8600000US51453,51453,ZCTA5 51453,304,155,149
8600000US51454,51454,ZCTA5 51454,616,316,300
8600000US51455,51455,ZCTA5 51455,1023,515,508
8600000US51458,51458,ZCTA5 51458,635,325,310
8600000US51459,51459,ZCTA5 51459,31,23,8
8600000US51461,51461,ZCTA5 51461,487,208,279
8600000US51462,51462,ZCTA5 51462,406,213,193
8600000US51463,51463,ZCTA5 51463,232,110,122
8600000US51465,51465,ZCTA5 51465,322,138,184
8600000US51466,51466,ZCTA5 51466,347,142,205
8600000US51467,51467,ZCTA5 51467,284,114,170
8600000US51501,51501,ZCTA5 51501,13734,8061,5673
8600000US51503,51503,ZCTA5 51503,14700,6323,8377
8600000US51510,51510,ZCTA5 51510,1488,754,734
8600000US51520,51520,ZCTA5 51520,105,67,38
8600000US51521,51521,ZCTA5 51521,786,344,442
8600000US51523,51523,ZCTA5 51523,162,86,76
8600000US51525,51525,ZCTA5 51525,444,208,236
8600000US51526,51526,ZCTA5 51526,605,169,436
8600000US51527,51527,ZCTA5 51527,154,77,77
8600000US51528,51528,ZCTA5 51528,336,200,136
8600000US51529,51529,ZCTA5 51529,755,367,388
8600000US51530,51530,ZCTA5 51530,412,195,217
8600000US51531,51531,ZCTA5 51531,315,131,184
8600000US51532,51532,ZCTA5 51532,259,115,144
8600000US51533,51533,ZCTA5 51533,376,152,224
8600000US51534,51534,ZCTA5 51534,3321,1215,2106
8600000US51535,51535,ZCTA5 51535,722,369,353
8600000US51536,51536,ZCTA5 51536,164,64,100
8600000US51537,51537,ZCTA5 51537,2905,1454,1451
8600000US51540,51540,ZCTA5 51540,168,94,74
8600000US51541,51541,ZCTA5 51541,130,55,75
8600000US51542,51542,ZCTA5 51542,351,89,262
8600000US51543,51543,ZCTA5 51543,209,102,107
8600000US51544,51544,ZCTA5 51544,388,174,214
8600000US51545,51545,ZCTA5 51545,126,105,21
8600000US51546,51546,ZCTA5 51546,1079,403,676
8600000US51548,51548,ZCTA5 51548,143,54,89
8600000US51549,51549,ZCTA5 51549,184,79,105
8600000US51550,51550,ZCTA5 51550,65,33,32
8600000US51551,51551,ZCTA5 51551,646,209,437
8600000US51552,51552,ZCTA5 51552,127,44,83
8600000US51553,51553,ZCTA5 51553,391,128,263
8600000US51554,51554,ZCTA5 51554,76,69,7
8600000US51555,51555,ZCTA5 51555,2139,998,1141
8600000US51556,51556,ZCTA5 51556,181,83,98
8600000US51557,51557,ZCTA5 51557,347,168,179
8600000US51558,51558,ZCTA5 51558,229,115,114
8600000US51559,51559,ZCTA5 51559,682,301,381
8600000US51560,51560,ZCTA5 51560,866,279,587
8600000US51561,51561,ZCTA5 51561,496,248,248
8600000US51562,51562,ZCTA5 51562,146,52,94
8600000US51563,51563,ZCTA5 51563,278,143,135
8600000US51564,51564,ZCTA5 51564,214,135,79
8600000US51565,51565,ZCTA5 51565,208,114,94
8600000US51566,51566,ZCTA5 51566,3027,1808,1219
8600000US51570,51570,ZCTA5 51570,389,171,218
8600000US51571,51571,ZCTA5 51571,220,79,141
8600000US51572,51572,ZCTA5 51572,177,119,58
8600000US51573,51573,ZCTA5 51573,448,155,293
8600000US51575,51575,ZCTA5 51575,651,213,438
8600000US51576,51576,ZCTA5 51576,707,176,531
8600000US51577,51577,ZCTA5 51577,511,223,288
8600000US51578,51578,ZCTA5 51578,37,18,19
8600000US51579,51579,ZCTA5 51579,984,429,555
8600000US51601,51601,ZCTA5 51601,2464,1471,993
8600000US51630,51630,ZCTA5 51630,98,51,47
8600000US51631,51631,ZCTA5 51631,131,69,62
8600000US51632,51632,ZCTA5 51632,2657,1377,1280
8600000US51636,51636,ZCTA5 51636,183,91,92
8600000US51637,51637,ZCTA5 51637,85,66,19
8600000US51638,51638,ZCTA5 51638,597,271,326
8600000US51639,51639,ZCTA5 51639,368,153,215
8600000US51640,51640,ZCTA5 51640,664,358,306
8600000US51645,51645,ZCTA5 51645,111,46,65
8600000US51646,51646,ZCTA5 51646,313,154,159
8600000US51647,51647,ZCTA5 51647,53,38,15
8600000US51648,51648,ZCTA5 51648,78,22,56
8600000US51649,51649,ZCTA5 51649,132,48,84
8600000US51650,51650,ZCTA5 51650,165,72,93
8600000US51652,51652,ZCTA5 51652,683,302,381
8600000US51653,51653,ZCTA5 51653,549,218,331
8600000US51654,51654,ZCTA5 51654,212,100,112
8600000US51656,51656,ZCTA5 51656,31,22,9
8600000US52001,52001,ZCTA5 52001,17587,9781,7806
8600000US52002,52002,ZCTA5 52002,6141,2009,4132
8600000US52003,52003,ZCTA5 52003,5424,2359,3065
8600000US52030,52030,ZCTA5 52030,152,84,68
8600000US52031,52031,ZCTA5 52031,2091,954,1137
8600000US52032,52032,ZCTA5 52032,609,195,414
8600000US52033,52033,ZCTA5 52033,1280,538,742
8600000US52035,52035,ZCTA5 52035,485,190,295
8600000US52037,52037,ZCTA5 52037,477,192,285
8600000US52038,52038,ZCTA5 52038,206,63,143
8600000US52039,52039,ZCTA5 52039,411,139,272
8600000US52040,52040,ZCTA5 52040,2251,1049,1202
8600000US52041,52041,ZCTA5 52041,649,232,417
8600000US52042,52042,ZCTA5 52042,653,312,341
8600000US52043,52043,ZCTA5 52043,989,484,505
8600000US52044,52044,ZCTA5 52044,53,26,27
8600000US52045,52045,ZCTA5 52045,932,387,545
8600000US52046,52046,ZCTA5 52046,783,197,586
8600000US52047,52047,ZCTA5 52047,228,134,94
8600000US52048,52048,ZCTA5 52048,143,55,88
8600000US52049,52049,ZCTA5 52049,593,300,293
8600000US52050,52050,ZCTA5 52050,278,142,136
8600000US52052,52052,ZCTA5 52052,1297,754,543
8600000US52053,52053,ZCTA5 52053,394,159,235
8600000US52054,52054,ZCTA5 52054,401,170,231
8600000US52057,52057,ZCTA5 52057,3151,1368,1783
8600000US52060,52060,ZCTA5 52060,3759,2142,1617
8600000US52064,52064,ZCTA5 52064,409,153,256
8600000US52065,52065,ZCTA5 52065,456,198,258
8600000US52066,52066,ZCTA5 52066,34,29,5
8600000US52068,52068,ZCTA5 52068,1516,428,1088
8600000US52069,52069,ZCTA5 52069,680,327,353
8600000US52070,52070,ZCTA5 52070,439,198,241
8600000US52072,52072,ZCTA5 52072,113,43,70
8600000US52073,52073,ZCTA5 52073,433,139,294
8600000US52074,52074,ZCTA5 52074,150,75,75
8600000US52076,52076,ZCTA5 52076,920,473,447
8600000US52077,52077,ZCTA5 52077,164,70,94
8600000US52078,52078,ZCTA5 52078,399,104,295
8600000US52079,52079,ZCTA5 52079,348,160,188
8600000US52101,52101,ZCTA5 52101,5303,2248,3055
8600000US52132,52132,ZCTA5 52132,840,414,426
8600000US52133,52133,ZCTA5 52133,235,78,157
8600000US52134,52134,ZCTA5 52134,153,90,63
8600000US52135,52135,ZCTA5 52135,345,199,146
8600000US52136,52136,ZCTA5 52136,2406,1160,1246
8600000US52140,52140,ZCTA5 52140,269,125,144
8600000US52141,52141,ZCTA5 52141,642,336,306
8600000US52142,52142,ZCTA5 52142,531,318,213
8600000US52144,52144,ZCTA5 52144,510,237,273
8600000US52146,52146,ZCTA5 52146,491,273,218
8600000US52147,52147,ZCTA5 52147,472,184,288
8600000US52151,52151,ZCTA5 52151,894,487,407
8600000US52154,52154,ZCTA5 52154,385,200,185
8600000US52155,52155,ZCTA5 52155,488,259,229
8600000US52156,52156,ZCTA5 52156,298,175,123
8600000US52157,52157,ZCTA5 52157,799,421,378
8600000US52158,52158,ZCTA5 52158,148,102,46
8600000US52159,52159,ZCTA5 52159,1101,535,566
8600000US52160,52160,ZCTA5 52160,511,264,247
8600000US52161,52161,ZCTA5 52161,602,275,327
8600000US52162,52162,ZCTA5 52162,1270,803,467
8600000US52163,52163,ZCTA5 52163,141,93,48
8600000US52164,52164,ZCTA5 52164,91,43,48
8600000US52165,52165,ZCTA5 52165,344,191,153
8600000US52166,52166,ZCTA5 52166,57,21,36
8600000US52168,52168,ZCTA5 52168,106,71,35
8600000US52169,52169,ZCTA5 52169,181,110,71
8600000US52170,52170,ZCTA5 52170,222,79,143
8600000US52171,52171,ZCTA5 52171,370,150,220
8600000US52172,52172,ZCTA5 52172,2508,1364,1144
8600000US52175,52175,ZCTA5 52175,1590,899,691
8600000US52201,52201,ZCTA5 52201,497,144,353
8600000US52202,52202,ZCTA5 52202,385,147,238
8600000US52203,52203,ZCTA5 52203,834,319,515
8600000US52205,52205,ZCTA5 52205,3131,1484,1647
8600000US52206,52206,ZCTA5 52206,830,220,610
8600000US52207,52207,ZCTA5 52207,189,92,97
8600000US52208,52208,ZCTA5 52208,1294,736,558
8600000US52209,52209,ZCTA5 52209,412,149,263
8600000US52210,52210,ZCTA5 52210,285,119,166
8600000US52211,52211,ZCTA5 52211,1065,524,541
8600000US52212,52212,ZCTA5 52212,92,45,47
8600000US52213,52213,ZCTA5 52213,1597,451,1146
8600000US52214,52214,ZCTA5 52214,1380,565,815
8600000US52215,52215,ZCTA5 52215,273,143,130
8600000US52216,52216,ZCTA5 52216,617,255,362
8600000US52217,52217,ZCTA5 52217,192,99,93
8600000US52218,52218,ZCTA5 52218,681,289,392
8600000US52219,52219,ZCTA5 52219,69,40,29
8600000US52220,52220,ZCTA5 52220,177,98,79
8600000US52221,52221,ZCTA5 52221,96,45,51
8600000US52222,52222,ZCTA5 52222,293,169,124
8600000US52223,52223,ZCTA5 52223,579,258,321
8600000US52224,52224,ZCTA5 52224,798,297,501
8600000US52225,52225,ZCTA5 52225,155,104,51
8600000US52227,52227,ZCTA5 52227,1092,326,766
8600000US52228,52228,ZCTA5 52228,1105,188,917
8600000US52229,52229,ZCTA5 52229,303,112,191
8600000US52231,52231,ZCTA5 52231,109,36,73
8600000US52232,52232,ZCTA5 52232,75,23,52
8600000US52233,52233,ZCTA5 52233,2994,1460,1534
8600000US52235,52235,ZCTA5 52235,311,158,153
8600000US52236,52236,ZCTA5 52236,219,62,157
8600000US52237,52237,ZCTA5 52237,573,226,347
8600000US52240,52240,ZCTA5 52240,14334,8133,6201
8600000US52241,52241,ZCTA5 52241,7817,3212,4605
8600000US52242,52242,ZCTA5 52242,0,0,0
8600000US52245,52245,ZCTA5 52245,9076,4030,5046
8600000US52246,52246,ZCTA5 52246,9730,5429,4301
8600000US52247,52247,ZCTA5 52247,2011,894,1117
8600000US52248,52248,ZCTA5 52248,710,346,364
8600000US52249,52249,ZCTA5 52249,482,200,282
8600000US52251,52251,ZCTA5 52251,263,120,143
8600000US52253,52253,ZCTA5 52253,1182,491,691
8600000US52254,52254,ZCTA5 52254,341,182,159
8600000US52255,52255,ZCTA5 52255,532,265,267
8600000US52257,52257,ZCTA5 52257,119,19,100
8600000US52301,52301,ZCTA5 52301,1491,819,672
8600000US52302,52302,ZCTA5 52302,15559,5893,9666
8600000US52305,52305,ZCTA5 52305,261,119,142
8600000US52306,52306,ZCTA5 52306,740,284,456
8600000US52307,52307,ZCTA5 52307,53,34,19
8600000US52308,52308,ZCTA5 52308,91,41,50
8600000US52309,52309,ZCTA5 52309,157,83,74
8600000US52310,52310,ZCTA5 52310,2731,1167,1564
8600000US52312,52312,ZCTA5 52312,51,44,7
8600000US52313,52313,ZCTA5 52313,174,55,119
8600000US52314,52314,ZCTA5 52314,1829,509,1320
8600000US52315,52315,ZCTA5 52315,453,185,268
8600000US52316,52316,ZCTA5 52316,638,279,359
8600000US52317,52317,ZCTA5 52317,6629,2149,4480
8600000US52318,52318,ZCTA5 52318,445,247,198
8600000US52320,52320,ZCTA5 52320,509,241,268
8600000US52321,52321,ZCTA5 52321,250,72,178
8600000US52322,52322,ZCTA5 52322,1197,464,733
8600000US52323,52323,ZCTA5 52323,438,211,227
8600000US52324,52324,ZCTA5 52324,767,191,576
8600000US52325,52325,ZCTA5 52325,403,102,301
8600000US52326,52326,ZCTA5 52326,237,152,85
8600000US52327,52327,ZCTA5 52327,1237,312,925
8600000US52328,52328,ZCTA5 52328,1022,192,830
8600000US52329,52329,ZCTA5 52329,351,126,225
8600000US52330,52330,ZCTA5 52330,331,150,181
8600000US52332,52332,ZCTA5 52332,805,336,469
8600000US52333,52333,ZCTA5 52333,2386,465,1921
8600000US52334,52334,ZCTA5 52334,73,4,69
8600000US52335,52335,ZCTA5 52335,303,183,120
8600000US52336,52336,ZCTA5 52336,907,318,589
8600000US52337,52337,ZCTA5 52337,342,160,182
8600000US52338,52338,ZCTA5 52338,1239,193,1046
8600000US52339,52339,ZCTA5 52339,1594,731,863
8600000US52340,52340,ZCTA5 52340,1057,488,569
8600000US52341,52341,ZCTA5 52341,372,63,309
8600000US52342,52342,ZCTA5 52342,1171,553,618
8600000US52345,52345,ZCTA5 52345,557,187,370
8600000US52346,52346,ZCTA5 52346,370,188,182
8600000US52347,52347,ZCTA5 52347,730,322,408
8600000US52348,52348,ZCTA5 52348,29,13,16
8600000US52349,52349,ZCTA5 52349,3001,1396,1605
8600000US52351,52351,ZCTA5 52351,511,72,439
8600000US52352,52352,ZCTA5 52352,627,209,418
8600000US52353,52353,ZCTA5 52353,3861,1989,1872
8600000US52354,52354,ZCTA5 52354,153,29,124
8600000US52355,52355,ZCTA5 52355,139,65,74
8600000US52356,52356,ZCTA5 52356,999,334,665
8600000US52358,52358,ZCTA5 52358,1537,560,977
8600000US52359,52359,ZCTA5 52359,128,67,61
8600000US52361,52361,ZCTA5 52361,1836,791,1045
8600000US52362,52362,ZCTA5 52362,370,192,178
8600000US52401,52401,ZCTA5 52401,1013,781,232
8600000US52402,52402,ZCTA5 52402,16592,6898,9694
8600000US52403,52403,ZCTA5 52403,9834,4128,5706
8600000US52404,52404,ZCTA5 52404,15950,8677,7273
8600000US52405,52405,ZCTA5 52405,10386,4528,5858
8600000US52411,52411,ZCTA5 52411,2516,357,2159
8600000US52501,52501,ZCTA5 52501,12182,7176,5006
8600000US52530,52530,ZCTA5 52530,429,224,205
8600000US52531,52531,ZCTA5 52531,2453,1271,1182
8600000US52533,52533,ZCTA5 52533,596,322,274
8600000US52534,52534,ZCTA5 52534,113,72,41
8600000US52535,52535,ZCTA5 52535,398,240,158
8600000US52536,52536,ZCTA5 52536,439,159,280
8600000US52537,52537,ZCTA5 52537,2552,1330,1222
8600000US52540,52540,ZCTA5 52540,587,275,312
8600000US52542,52542,ZCTA5 52542,217,118,99
8600000US52543,52543,ZCTA5 52543,102,23,79
8600000US52544,52544,ZCTA5 52544,3292,2030,1262
8600000US52548,52548,ZCTA5 52548,41,26,15
8600000US52549,52549,ZCTA5 52549,251,162,89
8600000US52550,52550,ZCTA5 52550,210,131,79
8600000US52551,52551,ZCTA5 52551,256,142,114
8600000US52552,52552,ZCTA5 52552,314,151,163
8600000US52553,52553,ZCTA5 52553,786,366,420
8600000US52554,52554,ZCTA5 52554,609,340,269
8600000US52555,52555,ZCTA5 52555,147,74,73
8600000US52556,52556,ZCTA5 52556,5294,3049,2245
8600000US52557,52557,ZCTA5 52557,0,0,0
8600000US52560,52560,ZCTA5 52560,200,103,97
8600000US52561,52561,ZCTA5 52561,340,182,158
8600000US52563,52563,ZCTA5 52563,665,379,286
8600000US52565,52565,ZCTA5 52565,748,451,297
8600000US52566,52566,ZCTA5 52566,82,45,37
8600000US52567,52567,ZCTA5 52567,329,131,198
8600000US52569,52569,ZCTA5 52569,276,183,93
8600000US52570,52570,ZCTA5 52570,294,183,111
8600000US52571,52571,ZCTA5 52571,655,343,312
8600000US52572,52572,ZCTA5 52572,471,270,201
8600000US52573,52573,ZCTA5 52573,50,13,37
8600000US52574,52574,ZCTA5 52574,350,222,128
8600000US52576,52576,ZCTA5 52576,225,125,100
8600000US52577,52577,ZCTA5 52577,6251,3437,2814
8600000US52580,52580,ZCTA5 52580,171,84,87
8600000US52581,52581,ZCTA5 52581,161,66,95
8600000US52583,52583,ZCTA5 52583,165,93,72
8600000US52584,52584,ZCTA5 52584,169,93,76
8600000US52585,52585,ZCTA5 52585,385,192,193
8600000US52586,52586,ZCTA5 52586,193,143,50
8600000US52588,52588,ZCTA5 52588,8,0,8
8600000US52590,52590,ZCTA5 52590,435,254,181
8600000US52591,52591,ZCTA5 52591,1334,721,613
8600000US52593,52593,ZCTA5 52593,43,23,20
8600000US52594,52594,ZCTA5 52594,152,77,75
8600000US52595,52595,ZCTA5 52595,174,100,74
8600000US52601,52601,ZCTA5 52601,12416,7177,5239
8600000US52619,52619,ZCTA5 52619,176,91,85
8600000US52620,52620,ZCTA5 52620,330,196,134
8600000US52621,52621,ZCTA5 52621,329,143,186
8600000US52623,52623,ZCTA5 52623,758,385,373
8600000US52624,52624,ZCTA5 52624,119,69,50
8600000US52625,52625,ZCTA5 52625,1014,505,509
8600000US52626,52626,ZCTA5 52626,570,331,239
8600000US52627,52627,ZCTA5 52627,5406,2890,2516
8600000US52630,52630,ZCTA5 52630,221,113,108
8600000US52632,52632,ZCTA5 52632,5244,3420,1824
8600000US52635,52635,ZCTA5 52635,336,192,144
8600000US52637,52637,ZCTA5 52637,952,445,507
8600000US52638,52638,ZCTA5 52638,194,77,117
8600000US52639,52639,ZCTA5 52639,798,373,425
8600000US52640,52640,ZCTA5 52640,576,283,293
8600000US52641,52641,ZCTA5 52641,4498,2237,2261
8600000US52644,52644,ZCTA5 52644,154,50,104
8600000US52645,52645,ZCTA5 52645,1269,607,662
8600000US52646,52646,ZCTA5 52646,117,61,56
8600000US52647,52647,ZCTA5 52647,85,42,43
8600000US52649,52649,ZCTA5 52649,344,214,130
8600000US52650,52650,ZCTA5 52650,341,178,163
8600000US52651,52651,ZCTA5 52651,273,110,163
8600000US52653,52653,ZCTA5 52653,1384,693,691
8600000US52654,52654,ZCTA5 52654,632,296,336
8600000US52655,52655,ZCTA5 52655,1965,1138,827
8600000US52656,52656,ZCTA5 52656,1066,387,679
8600000US52657,52657,ZCTA5 52657,24,8,16
8600000US52658,52658,ZCTA5 52658,387,167,220
8600000US52659,52659,ZCTA5 52659,573,289,284
8600000US52660,52660,ZCTA5 52660,75,42,33
8600000US52701,52701,ZCTA5 52701,33,14,19
8600000US52720,52720,ZCTA5 52720,362,93,269
8600000US52721,52721,ZCTA5 52721,294,133,161
8600000US52722,52722,ZCTA5 52722,14424,4729,9695
8600000US52726,52726,ZCTA5 52726,1815,431,1384
8600000US52727,52727,ZCTA5 52727,166,60,106
8600000US52728,52728,ZCTA5 52728,442,254,188
8600000US52729,52729,ZCTA5 52729,340,112,228
8600000US52730,52730,ZCTA5 52730,2162,1012,1150
8600000US52731,52731,ZCTA5 52731,318,143,175
8600000US52732,52732,ZCTA5 52732,11749,6501,5248
8600000US52737,52737,ZCTA5 52737,151,64,87
8600000US52738,52738,ZCTA5 52738,1359,639,720
8600000US52739,52739,ZCTA5 52739,246,175,71
8600000US52742,52742,ZCTA5 52742,3099,1160,1939
8600000US52745,52745,ZCTA5 52745,271,117,154
8600000US52746,52746,ZCTA5 52746,386,110,276
8600000US52747,52747,ZCTA5 52747,911,330,581
8600000US52748,52748,ZCTA5 52748,3560,1437,2123
8600000US52749,52749,ZCTA5 52749,380,103,277
8600000US52750,52750,ZCTA5 52750,202,62,140
8600000US52751,52751,ZCTA5 52751,390,156,234
8600000US52752,52752,ZCTA5 52752,188,103,85
8600000US52753,52753,ZCTA5 52753,2178,525,1653
8600000US52754,52754,ZCTA5 52754,549,229,320
8600000US52755,52755,ZCTA5 52755,817,366,451
8600000US52756,52756,ZCTA5 52756,704,174,530
8600000US52757,52757,ZCTA5 52757,57,36,21
8600000US52758,52758,ZCTA5 52758,85,36,49
8600000US52760,52760,ZCTA5 52760,173,82,91
8600000US52761,52761,ZCTA5 52761,11794,5695,6099
8600000US52765,52765,ZCTA5 52765,150,73,77
8600000US52766,52766,ZCTA5 52766,419,171,248
8600000US52767,52767,ZCTA5 52767,76,33,43
8600000US52768,52768,ZCTA5 52768,593,285,308
8600000US52769,52769,ZCTA5 52769,274,96,178
8600000US52772,52772,ZCTA5 52772,2070,825,1245
8600000US52773,52773,ZCTA5 52773,951,412,539
8600000US52774,52774,ZCTA5 52774,37,15,22
8600000US52776,52776,ZCTA5 52776,1444,596,848
8600000US52777,52777,ZCTA5 52777,513,241,272
8600000US52778,52778,ZCTA5 52778,1721,703,1018
8600000US52801,52801,ZCTA5 52801,536,398,138
8600000US52802,52802,ZCTA5 52802,3845,2573,1272
8600000US52803,52803,ZCTA5 52803,9182,5002,4180
8600000US52804,52804,ZCTA5 52804,10829,5218,5611
8600000US52806,52806,ZCTA5 52806,10972,5237,5735
8600000US52807,52807,ZCTA5 52807,6700,3415,3285
8600000US56027,56027,ZCTA5 56027,400,255,145
8600000US56121,56121,ZCTA5 56121,258,139,119
8600000US56168,56168,ZCTA5 56168,367,171,196
